5 x 10
**********
* H   ** *
*    * RR*
*      R *
**********

